Country	IsTelenorSupported
Austria	No
Belgium	No
Republic of Cyprus	No
Czech Republic	No
Denmark	Yes
Estonia	No
Finland	No
France	No
Germany	No
Greece	No
Hungary	Yes
Ireland	No
Italy	No
Latvia	No
Lithuania	No
Luxembourg	No
Malta	No
Netherlands	No
Poland	No
Portugal	No
Romania	No
Slovakia	No
Slovenia	No
Spain	No
Sweden	No
United Kingdom	No
Ukraine	No
